11111111111111111111111111111111111111111111111111111111111
11111111111111111111111111111111111111111111111111110000001
10000000000000000002000000011111111111111000000000000000001
10000000000000000002000000011111111111111000000000000000001
10060000000000000002000000011111111111111060000000000000001
11111111131100000011111000011111111111111111115115110000001
11111111111100000011111000011110000000000000000000000000001
11111111111100000011111000011110000000000000000000000000001
11111111111111111111111000011110000000000000000000000000001
11111111111111111111111000011110000000000000000000000111111
11111111111111111111000000000000000000000000000000000020001
11111111111111111111000000000000000000001111111111000020001
11111111111111111111000000000000070000001111111111000020001
11111111111111111111000011111411111111111111111111000020001
10000000000000000000000000011111111111111111111111000020001
10000000000000000000000000011111111111111111111111000020001
10060000000000000000000000011111111111111111111111111110001
11111111141111111411111100011111111111111111111111111110001
11111111111111111111000000011111111111111111111111111110001
11111111111111111111000000011111111111111111111111111110001
11111111111111111111000000011000000001110000000000011110001
11111111111111111111000011111000000001110000000000011110001
10000000000000000000000000000000000000000000000000011110001
10000000000000000000000000000000000000000000000000011110001
10060000000000000000000000000000000000000000000060011110001
11111111111111141111111111131111151111411115111111111110001
11111111111111111111111111111111111111111111111111111110001
11111111111111111111111111000000000000011111111111111110001
11111111111111111111111111000000000000011111111111111110001
11111111111111111111111111000000000000011111111111111110001
11111111111111111111111111000000000000011111111111111110001
11111111111111111111111111000111111100011111111111111110001
11111111111111111111111111000000111100011111111111111110001
11111111111111111111111111000000111100011111111111111110001
11111111100000011100000111111000111100011100000000000010001
11111111100000011100000111000000111100011100000000000010001
11111111100000011100000111000111111100000000000000000000001
10000000000000000000000000000111111100000000000000000000001
10008000000000000000000000000111111100000000000000000000001
11111111311115114115111141111111111111114115111115111131111